15 12
WWWWWWWWWWWW
OOOOOOOOOOOW
WWWWOOWWWWWW
WOOOOOOOOOOW
WOOOWWWWOOOW
WOOOOOOWOOOW
WWWWWWOWWWWW
WOOOOOOWOOOW
WOOWWWWWWOWW
WOOOOOOOOOOW
WWWWWWWWWWOW
WOOOOOOOOOOW
WOWWWWWWWWWW
WOOOOOOOOOOW
WWWWWWWWWWWW
J 1 0 % jogador
D 2 4 2 5 4 2 4 9 9 9 % diamantes
G 13 11 % portão
